111111111111111111111
111000000000000000111
111030000000000000111
111000000111111000111
111000000100000000111
111000000000000000111
111111111110000000111
111111111111100000111
111111111111110000111
111111111111110000111
111111111111110000111
111111111111110000111
111111111111000111111
111111111111000111111
111111111111000111111
111121111111000111111
100001111111110000001
101111111111111111101
101111111111111111101
100000000000000000001
111111111111111111111